111C111111111111
100C000E00000001
100C0000P0000001
1111111111111111