1111111111111111
100C000E00000001
100P000000000001
1111111111111111